NO ./path_to_the_north_texture
SO ./path_to_the_south_texture
WE ./path_to_the_west_texture
EA ./path_to_the_east_texture

F 30,120,200
C 220,220,220

1111111111111111111
1000000000000000001
1011110111000111101
10100001000S0100001
1010111101100111101
1010000000000000001
1010111111111111101
1010000000000000001
1111111111111111111