NO tex/bookshelf.xpm
SO tex/bookshelf.xpm
WE tex/bookshelf.xpm
EA tex/bookshelf.xpm

F 184,113,39
C 51,198,227

111111111111111
100000000000001
101111011111101
101000010000101
101011110110101
1010000E0100101
101011110110101
101000010000101
101111011111101
100000000000001
111111111111111
111111111111111
