NO tex/bookshelf.xpm
SO tex/bookshelf.xpm
WE tex/bookshelf.xpm
EA tex/bookshelf.xpm

F 12,      13,39
C 51,198,227

111111111
101111001
111  1001   
101111001
100S00001
111111111





